Usuario creado=User created
Perfil del usuario=User profile
Nombre de usuario=User name
Correo de usuario=User email
Usuario borrado=User deleted
Usuario actualizado=User updated
Fotografía del usuario=User photo
El usuario a sido eliminado correctamente=The user has been deleted
Crear usuario=Create user
Gestión de Usuarios=User Management
Usuarios=Users
Usuario=User
USUARIO=USER
Nueva Contraseña (Si no quieres modificar tu contraseña actual deja el campo en blanco)=New Password (If you don't want to change your current password, leave the field blank)
Repite la nueva contraseña=Repeat the new password
Repite la contraseña=Repeat the password
Recuérdame=Remember me
Contraseña=Password
Ingresar=Log in
Olvide la contraseña=Forgot password
Perfil=Profile
Actualizar Foto=Update Foto
GUARDAR INFORME=SAVE REPORT
Hay cambios sin guardar=There are unsaved changes
Guardar modelo de datos=Save data model
Guardar=Save
Gestión de Grupos=Groups management
MIS GRUPOS=MY GROUPS
GRUPOS=GROUPS
Cerrar sesión=Sign off
Mis informes=My reports
Selecciona una fuente de datos=Select a datasource
Selecciona un grupo=Select a group
Fuente de Datos=Datasource
Nueva Fuente=New datasource
Editar Fuente=Edit datasource
Modelo de datos=Data Model
NUEVO INFORME=NEW REPORT
CREA TU NUEVO INFORME=CREATE A NEW REPORT
PRIVADOS=PRIVATE
COMUNES=COMMON
PUBLICOS=PUBLIC
OPCIONES DEL PANEL=PANEL OPTIONS
Editar consulta=Edit query
EDITAR CONSULTA=EDIT QUERY
Editar opciones del gráfico=Edit chart options
Exportar a Excel=Export to Excel
Eliminar panel=Delete panel
VISTA PREVIA=PREVIEW
Entidades=Entities
Atributos=Attributes
Selección=Selection
Filtros=Filters
Mi consulta=My query
Resumen de atributos=Attribute Summary
Resumen de filtros del panel=Panel Filter Summary
Resumen de filtros del informe=Report filter summary
Confirmar=Confirm
Cancelar=Cancel
Dame un nombre=Give me a name
Nombre técnico=Technical Name
Público=Public
Grupo=Group
Privado=Private
Nuevo=New
Columna= Column
de la tabla=from the table
Agregaciones=Aggretations
Ordenación=Sort
Filtrar=Filter
Opciones=Options
Gráfico de Lineas= Line Chart
Gráfico de Barras Horizontales=Horizontal Bar Chart
Gráfico de Barras=Bar Chart
Gráfico de Área Polar=Pola Area Chart
Gráfico de Pastel=Pie Chart
Tabla Cruzada=Crosstab
Tabla de Datos=Table
NO IGUAL A=NOT EQUAL TO
IGUAL A=EQUAL TO
MAYOR o IGUAL A=GREATER OR EQUAL TO
MENOR o IGUAL A=LESS OR EQUAL TO
MAYOR A=GREATER THAN
MENOR A=LESS THAN
ENTRE (between)=BETWEEN
DENTRO DE (in)=IN
FUERA DE (not in)=NOT IN
PARECIDO A (like)=LIKE
VALORES NO NULOS (not null)=NOT NULL
AÑO=YEAR
MES=MONTH
DIA=DAY
NOMBRE *=NAME *
Nombre=Name
Descripción=Description
Esconder tabla=Hide this table
Tipo de tabla=Table type
Tipo de columna=Column type
Agregación=Aggregation
Relaciones=Relations
Roles y permisos de fila=Roles and row permissions
TIPO *=TYPE *
SERVIDOR *=SERVER *
BASE DE DATOS *=DATABASE *
ESQUEMA *=SCHEMA *
PUERTO *=PORT * 
CONTRASEÑA *=PASSWORD *
Valores Distintos=Count Distinct
Cuenta Valores=Count
Mínimo=Minimum
Máximo=Maximum
Media=Average
Suma=Sum
VALOR=VALUE
Totales=Totals
Quitar totales de columna=Remove column totals
Totales de columna=Column totals
Quitar Subtotales de columna=Remove column subtotals
Subtotales de columna=Column subtotals
Quitar totales de fila=Remove row totals
Totales de fila=Row totals
Valores y porcentajes=Values and percentages
Sólo valores=Values only
Sólo porcentajes=Percentages only
Añadir permiso=Add permission